1110000000000
0100011100000
1000011000600
0060001106000
0000000000000
0005001000000
0000011100000
0000000100000
0000001100400
1000011100000
1100011100000
1110001100001
1110000000011